1111111111111
1000010011001
1111000000001
1010000001001
100100^000111
1100001000001
1111111111111
