11111
11001
10>11
10101
11111
